11111111111111111111111111111111111111111111111111111111111111111111111
1P000000000000000000000000000000E0000000000000CCCCCCCCCCCCCCCCCCCCCCCC1
11111111111111111111111111111111111111111111111111111111111111111111111