111111111111111111111
1P0000000000000000001
1C11111111111111111C1
100000000000000100001
100000000000001000001
1E0000000000100000001
111111111111111111111